20 20
11 2 1 0 1 0 1 4 3 0 5 0 9 0 1 1 5 0 9 4 1 0 1 3 3 2 3 0 3 0 5 0 11 0 1 1 5 0 13 5 
9 0 6 1 12 5 12 0 9 0 6 0 8 2 6 0 14 0 12 0 10 3 2 0 3 3 5 0 13 4 8 0 3 1 4 1 10 0 4 2 
10 4 3 0 2 5 0 0 4 3 9 0 4 0 9 0 5 2 10 0 3 0 5 0 9 2 6 0 8 0 2 0 5 0 8 5 3 0 6 4 
9 0 1 2 1 1 6 0 12 0 12 5 10 5 6 0 8 0 3 2 1 0 6 0 12 0 9 5 4 0 9 0 4 5 8 2 3 3 5 0 
8 0 2 0 0 5 5 0 12 0 8 0 1 0 5 0 10 0 3 0 6 0 9 0 6 0 8 1 6 5 12 0 8 5 4 2 9 0 6 3 
10 5 1 0 6 0 10 0 4 0 12 0 10 0 2 0 1 1 3 5 3 1 6 0 11 0 4 0 13 0 12 0 12 0 12 0 10 0 5 0 
9 0 4 4 9 0 7 0 12 0 12 1 9 0 1 0 0 0 3 0 3 1 5 0 9 0 4 5 8 0 6 2 12 0 12 3 9 0 6 1 
8 0 2 0 0 5 1 2 4 0 12 0 12 4 12 0 8 0 3 2 1 3 0 0 0 0 0 0 4 0 11 0 4 0 12 3 10 5 5 0 
12 0 9 4 6 2 12 0 12 5 10 0 6 5 12 0 12 4 13 0 12 0 8 3 6 0 10 2 0 0 3 0 6 5 12 0 9 0 6 0 
12 5 10 0 5 0 12 0 8 0 1 0 5 3 12 0 12 0 8 2 4 0 14 4 9 0 3 0 2 0 5 0 11 0 4 1 8 0 5 5 
10 0 3 0 6 1 12 1 10 4 2 0 2 0 2 0 0 4 4 4 10 4 5 0 10 0 5 0 13 0 10 5 5 2 14 2 12 0 12 5 
9 0 3 0 5 0 8 0 5 4 9 0 3 5 5 0 10 0 2 1 5 0 8 0 5 5 10 4 4 0 13 0 10 0 3 0 0 0 4 0 
10 1 5 4 10 2 6 3 10 0 6 0 13 0 8 3 3 0 3 5 4 1 12 3 12 5 9 0 6 0 8 0 5 1 9 2 0 1 6 2 
9 5 6 1 11 0 1 0 1 0 5 3 12 0 10 5 3 0 3 2 6 4 12 3 10 0 6 5 9 3 6 0 12 0 14 5 10 3 5 0 
10 0 5 0 9 3 2 0 4 0 10 2 4 0 13 0 9 2 3 0 1 1 4 0 9 1 1 0 6 4 9 0 6 0 9 5 3 0 4 0 
13 0 12 0 10 0 5 5 8 5 5 4 12 0 8 0 2 5 7 5 12 4 12 5 8 0 4 0 9 5 6 0 9 0 2 0 5 0 12 1 
12 0 10 0 3 0 6 0 12 0 8 0 6 0 14 0 9 0 3 1 6 1 10 0 0 0 6 0 8 2 3 3 2 0 7 0 12 4 12 0 
8 0 1 0 3 0 1 0 4 0 8 0 3 0 1 5 4 0 9 0 3 0 1 3 6 0 9 3 0 5 1 4 3 0 3 3 6 1 12 0 
12 0 10 0 3 0 4 5 12 0 14 0 9 0 6 0 8 5 4 2 9 0 6 0 9 0 6 0 8 5 6 0 13 3 9 0 1 0 6 0 
10 0 3 1 7 3 10 3 2 0 3 0 6 0 11 5 6 4 10 5 2 0 3 0 2 0 3 5 2 5 3 3 2 0 2 4 2 0 7 4 
